99999999999999999999999999999999999999999999999999999999999999
92111111111111111111111111111111111111111111111111111111111129
97000000000000000000000000000070000000000000000000000000000079
97000000000000000000000000000070000000000000000000000000000079
97000011111111111110000000000000000000000001111111111111000079
97000700000000000000000000000000000000000000000000000000700079
97000700000000000000000000000070000000000000000000000000700079
97000700000000000000000000000070000000000000000000000000700079
97000700000000000000000000000070000000000000000000000000700079
97000700000000000000000000000000000000000000000000000000700079
97000700000000000000000000000000000000000000000000000000700079
97000700000000000000000000000000000000000000000000000000700079
97000000000000000000000000000070000000000000000000000000700079
97000000000000000000000000000070000000000000000000000000000079
97000000007000000000000000000070000000000000000000700000000079
97000000007000000000000000011121110000000000000000700000000079
97000000007000000000000000000070000000000000000000700000000079
97000000000000000000000000000070000000000000000000000000000079
97000000000000000000000000000070000000000000000000000000000079
97000700000000000000000000000000000000000000000000000000700079
97000700000000000000000000000000000000000000000000000000700079
97000700000000000000000000000000000000000000000000000000700079
97000700000000000000000000000070000000000000000000000000700079
97000700000000000000000000000070000000000000000000000000700079
97000700000000000000000000000070000000000000000000000000700079
97000700000000000000000000000000000000000000000000000000700079
97000700000000000000000000000000000000000000000000000000700079
97000011111111111110000000000000000000000001111111111111000079
97000000000000000000000000000070000000000000000000000000000079
97000000000000000000000000000070000000000000000000000000000079
92111111111111111111111111111111111111111111111111111111111129
99999999999999999999999999999999999999999999999999999999999999