99999999999999999999999999999999999999999999999999999999999999
92111111111111111111111111111111111111111111111111111111111129
97000000000000000000000000000000000000000000000000000000000079
97000000000000000000000000000000000000000000000000000000000079
97000000000000000000000000000000000000000000000000000000000079
97000000000000000000000000000000000000000000000000000000000079
97000000000000000000000000000000000000000000000000000000000079
97000000000000000000000000000000000000000000000000000000000079
97000000000000000000000000000000000000000000000000000000000079
97000000000000000000000000000000000000000000000000000000000079
97000000000000000000000000000000000000000000000000000000000079
97000000000000000000000000000000000000000000000000000000000079
97000000000000000000000000000000000000000000000000000000000079
97000000000000000000000000000000000000000000000000000000000079
97000000000000000000000000000000000000000000000000000000000079
97000000000000000000000000000000000000000000000000000000000079
97000000000000000000000000000000000000000000000000000000000079
97000000000000000000000000000000000000000000000000000000000079
97000000000000000000000000000000000000000000000000000000000079
97000000000000000000000000000000000000000000000000000000000079
97000000000000000000000000000000000000000000000000000000000079
97000000000000000000000000000000000000000000000000000000000079
97000000000000000000000000000000000000000000000000000000000079
97000000000000000000000000000000000000000000000000000000000079
97000000000000000000000000000000000000000000000000000000000079
97000000000000000000000000000000000000000000000000000000000079
97000000000000000000000000000000000000000000000000000000000079
97000000000000000000000000000000000000000000000000000000000079
97000000000000000000000000000000000000000000000000000000000079
97000000000000000000000000000000000000000000000000000000000079
92111111111111111111111111111111111111111111111111111111111129
99999999999999999999999999999999999999999999999999999999999999
