99999999999999999999999999999999999999999999999999999999999999
92111111111111111111111111111111111111111111111111111111111129
97000000000000000000000000000000000000000000000000000000000079
97000000000000000000000000000000000000000000000000000000000079
97000000000000000000000000000000000000000000000000000000000079
97000000000000000000000000000000000000000000000000000000000079
97000000000000000000000000000000000000000000000000000000000079
97000000000000000000000000000000000000000000000000000000000079
97000000000000000000000000000000000000000000000000000000000079
97000000000000000000000000000070000000000000000000000000000079
97000000000000000000000000000070000000000000000000000000000079
97000000000000000000000000000070000000000000000000000000000079
97000000000000000000000000000070000000000000000000000000000079
97000000000000000000000000000070000000000000000000000000000079
97000000000000000000000000000070000000000000000000000000000079
97000000000000000000111111111121111111111000000000000000000079
97000000000000000000000000000070000000000000000000000000000079
97000000000000000000000000000070000000000000000000000000000079
97000000000000000000000000000070000000000000000000000000000079
97000000000000000000000000000070000000000000000000000000000079
97000000000000000000000000000070000000000000000000000000000079
97000000000000000000000000000070000000000000000000000000000079
97000000000000000000000000000000000000000000000000000000000079
97000000000000000000000000000000000000000000000000000000000079
97000000000000000000000000000000000000000000000000000000000079
97000000000000000000000000000000000000000000000000000000000079
97000000000000000000000000000000000000000000000000000000000079
97000000000000000000000000000000000000000000000000000000000079
97000000000000000000000000000000000000000000000000000000000079
97000000000000000000000000000000000000000000000000000000000079
92111111111111111111111111111111111111111111111111111111111129
99999999999999999999999999999999999999999999999999999999999999